SELECT COUNT(*) FROM singer	concert_singer
SELECT COUNT(*) FROM singer	concert_singer
SELECT singer.name, singer.country, singer.age FROM singer JOIN singer_in_concert ON singer.Singer_ID = singer_in_concert.Singer_ID JOIN concert ON concert.concert_ID = singer_in_concert.concert_ID ORDER BY singer.age DESC	concert_singer
SELECT name, country, age FROM singer JOIN singer_in_concert ON singer.Singer_ID = singer_in_concert.Singer_ID JOIN concert ON concert.concert_ID = singer_in_concert.concert_ID ORDER BY age DESC	concert_singer
SELECT AVG(Age) AS Average_Age, MIN(Age) AS Minimum_Age, MAX(Age) AS Maximum_Age FROM singer WHERE Country = 'France'	concert_singer
SELECT AVG(Age) AS Average_Age, MIN(Age) AS Minimum_Age, MAX(Age) AS Maximum_Age FROM singer WHERE Country = 'France' AND Is_male = TRUE	concert_singer
SELECT `singer`.`Song_release_year`, `singer`.`Name` FROM `singer` JOIN (SELECT MIN(`Age`) AS MinAge, `Singer_ID` FROM `singer` JOIN `singer_in_concert` ON `singer`.`Singer_ID` = `singer_in_concert`.`Singer_ID` GROUP BY `Singer_ID`) AS YoungestSinger ON `singer`.`Singer_ID` = YoungestSinger.Singer_ID JOIN `concert` ON `concert`.`concert_ID` = `singer_in_concert`.`concert_ID`	concert_singer
SELECT song_name, song_release_year FROM singer JOIN singer_in_concert ON singer.singer_id = singer_in_concert.singer_id JOIN concert ON concert.concert_id = singer_in_concert.concert_id JOIN stadium ON stadium.stadium_id = concert.stadium_id WHERE singer.age = (SELECT MIN(age) FROM singer)	concert_singer
SELECT DISTINCT country FROM singer WHERE Age > 20 AND Singer_ID IN (SELECT Singer_ID FROM singer_in_concert)	concert_singer
SELECT DISTINCT country FROM singer WHERE age > 20	concert_singer
SELECT Country, COUNT(*) FROM singer GROUP BY Country	concert_singer
SELECT country, COUNT(*) FROM singer GROUP BY country	concert_singer
SELECT Song_Name FROM singer_in_concert JOIN singer ON singer_in_concert.Singer_ID = singer.Singer_ID JOIN concert ON concert.concert_ID = singer_in_concert.concert_ID JOIN stadium ON concert.Stadium_ID = stadium.Stadium_ID WHERE singer.Age > (SELECT AVG(singer.Age) FROM singer)	concert_singer
SELECT Song_Name FROM singer JOIN singer_in_concert ON singer.Singer_ID = singer_in_concert.Singer_ID JOIN concert ON concert.concert_ID = singer_in_concert.concert_ID JOIN stadium ON concert.Stadium_ID = stadium.Stadium_ID WHERE singer.Age > (SELECT AVG(singer.Age) FROM singer)	concert_singer
SELECT T2.location, T2.name FROM stadium AS T1 JOIN concert AS T3 ON T1.stadium_id = T3.stadium_id JOIN singer_in_concert AS T4 ON T3.concert_id = T4.concert_id JOIN singer AS T2 ON T4.singer_id = T2.Singer_ID WHERE T1.capacity BETWEEN 5000 AND 10000	concert_singer
SELECT name, location FROM stadium WHERE capacity BETWEEN 5000 AND 10000	concert_singer
SELECT MAX(Capacity) AS Max_Capacity, AVG(Capacity) AS Average_Capacity FROM stadium	concert_singer
SELECT AVG(Capacity) AS average_capacity, MAX(Capacity) AS max_capacity FROM stadium	concert_singer
SELECT name, capacity FROM stadium ORDER BY average DESC LIMIT 1	concert_singer
SELECT name, capacity FROM stadium ORDER BY average DESC LIMIT 1	concert_singer
SELECT COUNT(*) FROM concert WHERE year IN ('2014', '2015')	concert_singer
SELECT COUNT(*) FROM concert WHERE year IN ('2014', '2015')	concert_singer
SELECT T2.Name, COUNT(*) FROM concert AS T1 JOIN stadium AS T2 ON T1.Stadium_ID = T2.Stadium_ID GROUP BY T1.Stadium_ID	concert_singer
SELECT T2.Stadium_ID, COUNT(*) AS concert_count FROM concert AS T1 JOIN stadium AS T2 ON T1.Stadium_ID = T2.Stadium_ID GROUP BY T2.Stadium_ID	concert_singer
SELECT T2.name, T2.capacity FROM concert AS T1 JOIN stadium AS T2 ON T1.stadium_id = T2.stadium_id WHERE T1.year > = 2014 GROUP BY T2.stadium_id ORDER BY COUNT(*) DESC LIMIT 1	concert_singer
SELECT T2.name, T2.capacity FROM concert AS T1 JOIN stadium AS T2 ON T1.stadium_id = T2.stadium_id WHERE T1.year > 2013 AND T1.concert_ID IN (SELECT concert_ID FROM concert GROUP BY concert_ID ORDER BY COUNT(*) DESC LIMIT 1)	concert_singer
SELECT Year FROM concert GROUP BY Year ORDER BY COUNT(*) DESC LIMIT 1	concert_singer
SELECT Year FROM concert GROUP BY Year ORDER BY COUNT(*) DESC LIMIT 1	concert_singer
SELECT name FROM stadium EXCEPT SELECT T2.name FROM concert AS T1 JOIN singer_in_concert AS T3 ON T1.concert_ID = T3.concert_ID JOIN stadium AS T2 ON T1.Stadium_ID = T2.Stadium_ID	concert_singer
SELECT T1.Name FROM stadium AS T1 WHERE T1.Stadium_ID NOT IN (SELECT T2.Stadium_ID FROM concert AS T2 JOIN singer_in_concert AS T3 ON T2.concert_ID = T3.concert_ID)	concert_singer
SELECT DISTINCT country FROM singer WHERE age > 40 INTERSECT SELECT country FROM singer WHERE age < 30	concert_singer
SELECT name FROM stadium WHERE Stadium_ID NOT IN (SELECT Stadium_ID FROM concert WHERE Year = '2014')	concert_singer
SELECT name FROM stadium EXCEPT SELECT T2.name FROM concert AS T1 JOIN stadium AS T2 ON T1.Stadium_ID = T2.Stadium_ID WHERE T1.Year = '2014'	concert_singer
SELECT concert_name, theme, COUNT(singer_id) AS num_singers FROM concert JOIN singer_in_concert ON concert.concert_ID = singer_in_concert.concert_ID GROUP BY concert_name, theme	concert_singer
SELECT T1.concert_Name, T1.Theme, COUNT(T2.Singer_ID) FROM concert AS T1 JOIN singer_in_concert AS T2 ON T1.concert_ID = T2.concert_ID GROUP BY T1.concert_Name, T1.Theme	concert_singer
SELECT T1.Name, COUNT(*) FROM singer AS T1 JOIN singer_in_concert AS T2 ON T1.Singer_ID = T2.Singer_ID JOIN concert AS T3 ON T2.concert_ID = T3.concert_ID GROUP BY T1.Singer_ID	concert_singer
SELECT T1.Name, COUNT(*) AS Number_of_Concerts FROM singer_in_concert AS T1 JOIN singer AS T2 ON T1.Singer_ID = T2.Singer_ID JOIN concert AS T3 ON T1.concert_ID = T3.concert_ID GROUP BY T1.Singer_ID	concert_singer
SELECT T3.Name FROM concert AS T1 JOIN stadium AS T2 ON T1.Stadium_ID = T2.Stadium_ID JOIN singer_in_concert AS T4 ON T1.concert_ID = T4.concert_ID JOIN singer AS T3 ON T4.Singer_ID = T3.Singer_ID WHERE T1.Year = '2014'	concert_singer
SELECT T2.Name FROM singer_in_concert AS T1 JOIN singer AS T2 ON T1.Singer_ID = T2.Singer_ID JOIN concert AS T3 ON T1.concert_ID = T3.concert_ID WHERE T3.Year = 2014	concert_singer
SELECT T1.Name, T1.Country FROM singer AS T1 JOIN singer_in_concert AS T2 ON T1.Singer_ID = T2.Singer_ID JOIN concert AS T3 ON T2.concert_ID = T3.concert_ID WHERE T3.Theme LIKE '%Hey%' AND T1.Song_Name LIKE '%Hey%'	concert_singer
SELECT T1.Name, T1.Country FROM singer AS T1 JOIN singer_in_concert AS T2 ON T1.Singer_ID = T2.Singer_ID JOIN concert AS T3 ON T2.concert_ID = T3.concert_ID WHERE T3.Theme LIKE '%Hey%'	concert_singer
SELECT T1.Name, T1.Location FROM stadium AS T1 JOIN concert AS T2 ON T1.Stadium_ID = T2.Stadium_ID WHERE T2.Year IN ('2014', '2015') AND T2.Year IN (SELECT Year FROM concert GROUP BY Year HAVING COUNT(*) > 1)	concert_singer
SELECT T1.Name, T1.Location FROM stadium AS T1 WHERE T1.Stadium_ID IN (SELECT T2.Stadium_ID FROM concert AS T2 WHERE YEAR(T2.Year) = 2014 INTERSECT SELECT T3.Stadium_ID FROM concert AS T3 WHERE YEAR(T3.Year) = 2015)	concert_singer
SELECT COUNT(*) FROM concert WHERE stadium_id = (SELECT stadium_id FROM stadium ORDER BY capacity DESC LIMIT 1)	concert_singer
SELECT COUNT(*) FROM concert WHERE stadium_id = (SELECT stadium_id FROM stadium ORDER BY Capacity DESC LIMIT 1)	concert_singer
SELECT COUNT(*) FROM Pets WHERE weight > 10	pets_1
SELECT COUNT(*) FROM Pets WHERE weight > 10	pets_1
SELECT weight FROM pets WHERE PetType = 'Dog' AND pet_age = (SELECT MIN(pet_age) FROM pets WHERE PetType = 'Dog')	pets_1
SELECT weight FROM pets JOIN Has_Pet ON Pets.PetID = Has_Pet.PetID JOIN Student ON Has_Pet.StuID = Student.StuID WHERE PetType = 'Dog' AND (SELECT Age FROM Student WHERE StuID = Has_Pet.StuID) = (SELECT MIN(Age) FROM Student)	pets_1
SELECT MAX(weight), PetType FROM Pets GROUP BY PetType	pets_1
SELECT MAX(weight), PetType FROM Pets GROUP BY PetType	pets_1
SELECT COUNT(*) FROM Has_Pet HP JOIN Student S ON HP.StuID = S.StuID WHERE S.Age > 20	pets_1
SELECT COUNT(*) FROM Has_Pet WHERE StuID IN (SELECT StuID FROM Student WHERE Age > 20)	pets_1
SELECT COUNT(*) FROM Pets WHERE PetType = 'Dog' AND StuID IN (SELECT StuID FROM Student WHERE Sex = 'F')	pets_1
SELECT COUNT(*) FROM Pets WHERE PetType = 'Dog' AND Student.Sex = 'f' AND Has_Pet.StuID = Student.StuID	pets_1
SELECT DISTINCT PetType FROM Pets	pets_1
SELECT DISTINCT PetType FROM Pets	pets_1
SELECT T1.Fname FROM Student AS T1 JOIN Has_Pet AS T2 ON T1.StuID = T2.StuID WHERE T2.PetID IN (SELECT PetID FROM Pets WHERE PetType = 'cat' OR PetType = 'dog')	pets_1
SELECT T1.Fname FROM Student AS T1 JOIN Has_Pet AS T2 ON T1.StuID = T2.StuID WHERE T2.PetID IN (SELECT PetID FROM Pets WHERE PetType IN ('Cat', 'Dog'))	pets_1
SELECT T1.Fname FROM Student AS T1 JOIN Has_Pet AS T2 ON T1.StuID = T2.StuID WHERE T2.PetID IN (SELECT PetID FROM Pets WHERE PetType = 'cat') AND T2.PetID IN (SELECT PetID FROM Pets WHERE PetType = 'dog')	pets_1
SELECT T1.Fname FROM Student AS T1 JOIN Has_Pet AS T2 ON T1.StuID = T2.StuID WHERE T2.PetID IN (SELECT PetID FROM Pets WHERE PetType = 'cat') AND T2.PetID IN (SELECT PetID FROM Pets WHERE PetType = 'dog')	pets_1
SELECT T1.Major, T1.Age FROM Student AS T1 WHERE PetID NOT IN (SELECT PetID FROM Has_Pet WHERE PetType = 'cat')	pets_1
SELECT T1.Major, T1.Age FROM Student AS T1 LEFT JOIN Has_Pet AS T2 ON T1.StuID = T2.StuID WHERE T2.PetID NOT IN (SELECT PetID FROM Pets WHERE PetType = 'cat')	pets_1
SELECT StuID FROM Student WHERE StuID NOT IN (SELECT StuID FROM Has_Pet WHERE PetID IN (SELECT PetID FROM Pets WHERE PetType = 'cat'))	pets_1
SELECT StuID FROM Student WHERE PetID NOT IN (SELECT PetID FROM Has_Pet WHERE PetType = 'cat')	pets_1
SELECT T1.Fname, T1.Age FROM Student AS T1 JOIN Has_Pet AS T2 ON T1.StuID = T2.StuID WHERE T2.PetID IN (SELECT PetID FROM Pets WHERE PetType = 'Dog') AND T2.PetID NOT IN (SELECT PetID FROM Has_Pet JOIN Pets ON Has_Pet.PetID = Pets.PetID WHERE Pets.PetType = 'Cat')	pets_1
SELECT T1.Fname FROM Student AS T1 JOIN Has_Pet AS T2 ON T1.StuID = T2.StuID WHERE T2.PetID IN (SELECT PetID FROM Pets WHERE PetType = 'Dog') AND T2.PetID NOT IN (SELECT PetID FROM Has_Pet WHERE PetType = 'Cat')	pets_1
SELECT PetType, weight FROM Pets JOIN Has_Pet ON Pets.PetID = Has_Pet.PetID JOIN Student ON Has_Pet.StuID = Student.StuID ORDER BY Age ASC LIMIT 1	pets_1
SELECT PetType, weight FROM Pets JOIN Has_Pet ON Pets.PetID = Has_Pet.PetID JOIN Student ON Has_Pet.StuID = Student.StuID ORDER BY pet_age ASC LIMIT 1	pets_1
SELECT PetID, weight FROM Pets WHERE pet_age > 1	pets_1
SELECT PetID, weight FROM Pets WHERE pet_age > 1	pets_1
SELECT PetType, AVG(Age) AS avg_age, MAX(Age) AS max_age FROM Student JOIN Has_Pet ON Student.StuID = Has_Pet.StuID JOIN Pets ON Has_Pet.PetID = Pets.PetID GROUP BY PetType	pets_1
SELECT PetType, AVG(Age) AS avg_age, MAX(Age) AS max_age FROM Student JOIN Has_Pet ON Student.StuID = Has_Pet.StuID JOIN Pets ON Has_Pet.PetID = Pets.PetID GROUP BY PetType	pets_1
SELECT PetType, AVG(weight) FROM Pets JOIN Has_Pet ON Pets.PetID = Has_Pet.PetID GROUP BY PetType	pets_1
SELECT PetType, AVG(weight) FROM Pets JOIN Has_Pet ON Pets.PetID = Has_Pet.PetID GROUP BY PetType	pets_1
SELECT T1.Fname, T1.Age FROM Student AS T1 JOIN Has_Pet AS T2 ON T1.StuID = T2.StuID	pets_1
SELECT T1.Fname, T1.Age FROM Student AS T1 JOIN Has_Pet AS T2 ON T1.StuID = T2.StuID JOIN Pets AS T3 ON T2.PetID = T3.PetID	pets_1
SELECT PetID FROM Has_Pet JOIN Student ON Has_Pet.StuID = Student.StuID WHERE Student.LName = 'smith'	pets_1
SELECT PetID FROM Has_Pet JOIN Student ON Has_Pet.StuID = Student.StuID WHERE Lname = 'Smith'	pets_1
SELECT T1.StuID, COUNT(T2.PetID) AS NumberOfPets FROM Student AS T1 JOIN Has_Pet AS T2 ON T1.StuID = T2.StuID GROUP BY T1.StuID	pets_1
SELECT T1.StuID, COUNT(*) FROM Student AS T1 JOIN Has_Pet AS T2 ON T1.StuID = T2.StuID GROUP BY T1.StuID	pets_1
SELECT T1.Fname, T1.Sex FROM Student AS T1 JOIN Has_Pet AS T2 ON T1.StuID = T2.StuID GROUP BY T1.StuID HAVING COUNT(*) > 1	pets_1
SELECT T1.Fname, T1.Sex FROM Student AS T1 JOIN Has_Pet AS T2 ON T1.StuID = T2.StuID GROUP BY T1.StuID HAVING COUNT(T2.PetID) > 1	pets_1
SELECT LName FROM Student WHERE StuID IN (SELECT StuID FROM Has_Pet WHERE PetID IN (SELECT PetID FROM Pets WHERE pet_age = 3 AND PetType = 'cat'))	pets_1
SELECT LName FROM Student WHERE StuID IN (SELECT StuID FROM Has_Pet JOIN Pets ON Has_Pet.PetID = Pets.PetID WHERE PetType = 'Cat' AND pet_age = 3) LIMIT 1	pets_1
SELECT AVG(Age) FROM Student WHERE StuID NOT IN (SELECT StuID FROM Has_Pet)	pets_1
SELECT AVG(Age) FROM Student WHERE StuID NOT IN (SELECT StuID FROM Has_Pet)	pets_1
SELECT COUNT(*) FROM employee	employee_hire_evaluation
SELECT COUNT(*) FROM employee	employee_hire_evaluation
SELECT name FROM employee ORDER BY age ASC	employee_hire_evaluation
SELECT name FROM employee ORDER BY age ASC	employee_hire_evaluation
SELECT City, COUNT(*) FROM employee GROUP BY City	employee_hire_evaluation
SELECT City, COUNT(*) FROM employee GROUP BY City	employee_hire_evaluation
SELECT DISTINCT City FROM employee WHERE Employee_ID IN (SELECT Employee_ID FROM evaluation JOIN employee ON evaluation.Employee_ID = employee.Employee_ID WHERE Age < 30 GROUP BY Employee_ID HAVING COUNT(*) > 1)	employee_hire_evaluation
SELECT DISTINCT City FROM employee WHERE Employee_ID IN (SELECT Employee_ID FROM evaluation JOIN hiring ON evaluation.Employee_ID = hiring.Employee_ID WHERE hiring.Age < 30 AND hiring.Is_full_time = false GROUP BY Employee_ID HAVING COUNT(*) > 1)	employee_hire_evaluation
SELECT Location FROM shop GROUP BY Location	employee_hire_evaluation
SELECT Location, COUNT(*) FROM shop GROUP BY Location	employee_hire_evaluation
SELECT T3.Manager_name, T2.District FROM shop AS T1 JOIN hiring AS T2 ON T1.Shop_ID = T2.Shop_ID JOIN employee AS T3 ON T2.Employee_ID = T3.Employee_ID JOIN evaluation AS T4 ON T2.Employee_ID = T4.Employee_ID WHERE T1.Number_products = (SELECT MAX(T5.Number_products) FROM shop AS T5)	employee_hire_evaluation
SELECT T3.Manager_name, T2.District FROM shop AS T1 JOIN hiring AS T2 ON T1.Shop_ID = T2.Shop_ID JOIN employee AS T3 ON T2.Employee_ID = T3.Employee_ID JOIN evaluation AS T4 ON T2.Employee_ID = T4.Employee_ID WHERE T1.Number_products = (SELECT MAX(T5.Number_products) FROM shop AS T5)	employee_hire_evaluation
SELECT MIN(Number_products), MAX(Number_products) FROM shop	employee_hire_evaluation
SELECT MIN(Number_products) FROM shop; SELECT MAX(Number_products) FROM shop	employee_hire_evaluation
SELECT T2.Name, T2.Location, T2.District FROM shop AS T1 JOIN employee AS T2 ON T1.Shop_ID = T2.Employee_ID JOIN hiring AS T3 ON T2.Employee_ID = T3.Employee_ID JOIN shop AS T4 ON T1.Shop_ID = T4.Shop_ID ORDER BY T4.Number_products DESC	employee_hire_evaluation
SELECT T2.name, T2.Location, T2.District FROM shop AS T1 JOIN employee AS T2 ON T1.Shop_ID = T2.Employee_ID JOIN hiring AS T3 ON T2.Employee_ID = T3.Employee_ID JOIN evaluation AS T4 ON T2.Employee_ID = T4.Employee_ID JOIN shop AS T5 ON T1.Shop_ID = T5.Shop_ID ORDER BY T5.Number_products DESC	employee_hire_evaluation
SELECT T1.Name FROM shop AS T1 JOIN (SELECT Shop_ID, AVG(Number_products) as avg_num_products FROM shop GROUP BY Shop_ID) AS T2 ON T1.Shop_ID = T2.Shop_ID WHERE T1.Number_products > T2.avg_num_products	employee_hire_evaluation
SELECT T3.Name FROM shop AS T1 JOIN hiring AS T2 ON T1.Shop_ID = T2.Shop_ID JOIN employee AS T3 ON T2.Employee_ID = T3.Employee_ID JOIN evaluation AS T4 ON T3.Employee_ID = T4.Employee_ID WHERE T1.Shop_ID NOT IN (SELECT T5.Shop_ID FROM shop AS T5 LEFT JOIN hiring AS T6 ON T5.Shop_ID = T6.Shop_ID LEFT JOIN employee AS T7 ON T6.Employee_ID = T7.Employee_ID LEFT JOIN evaluation AS T8 ON T7.Employee_ID = T8.Employee_ID GROUP BY T5.Shop_ID HAVING AVG(T8.Bonus) IS NULL OR AVG(T8.Bonus) < (SELECT AVG(Bonus) FROM evaluation WHERE Employee_ID IN (SELECT Employee_ID FROM employee))) AND T1.Number_products > (SELECT AVG(Number_products) FROM shop)	employee_hire_evaluation
SELECT T1.Name FROM evaluation AS T1 JOIN employee AS T2 ON T1.Employee_ID = T2.Employee_ID GROUP BY T1.Employee_ID ORDER BY COUNT(T1.Employee_ID) DESC LIMIT 1	employee_hire_evaluation
SELECT T1.Name FROM evaluation AS T1 JOIN employee AS T2 ON T1.Employee_ID = T2.Employee_ID GROUP BY T1.Employee_ID ORDER BY COUNT(T1.Employee_ID) DESC LIMIT 1	employee_hire_evaluation
SELECT Name FROM employee JOIN evaluation ON employee.Employee_ID = evaluation.Employee_ID WHERE evaluation.Year_awarded = (SELECT Year_awarded FROM evaluation WHERE Employee_ID = (SELECT Employee_ID FROM evaluation ORDER BY Bonus DESC LIMIT 1) AND Bonus > 0) AND Is_full_time = TRUE LIMIT 1	employee_hire_evaluation
SELECT T1.Name FROM evaluation AS T1 WHERE T1.Employee_ID = (SELECT Employee_ID FROM evaluation ORDER BY Bonus DESC LIMIT 1)	employee_hire_evaluation
SELECT name FROM employee WHERE Employee_ID NOT IN (SELECT Employee_ID FROM evaluation)	employee_hire_evaluation
SELECT Name FROM employee WHERE Employee_ID NOT IN (SELECT Employee_ID FROM evaluation)	employee_hire_evaluation
SELECT T3.Name FROM shop AS T1 JOIN hiring AS T2 ON T1.Shop_ID = T2.Shop_ID JOIN employee AS T3 ON T2.Employee_ID = T3.Employee_ID GROUP BY T1.Shop_ID ORDER BY COUNT(*) DESC LIMIT 1	employee_hire_evaluation
SELECT T2.Name FROM shop AS T1 JOIN hiring AS T2 ON T1.Shop_ID = T2.Shop_ID JOIN employee AS T3 ON T2.Employee_ID = T3.Employee_ID GROUP BY T1.Shop_ID ORDER BY COUNT(*) DESC LIMIT 1	employee_hire_evaluation
SELECT T1.Name FROM shop AS T1 LEFT JOIN hiring AS T2 ON T1.Shop_ID = T2.Shop_ID WHERE T2.Employee_ID IS NULL	employee_hire_evaluation
SELECT T3.Name FROM shop AS T3 LEFT JOIN hiring AS T1 ON T3.Shop_ID = T1.Shop_ID LEFT JOIN employee AS T2 ON T1.Employee_ID = T2.Employee_ID WHERE T2.Employee_ID IS NULL	employee_hire_evaluation
SELECT T1.Name, T2.Shop_ID, COUNT(*) FROM hiring AS T1 JOIN employee AS T2 ON T1.Employee_ID = T2.Employee_ID JOIN shop AS T3 ON T1.Shop_ID = T3.Shop_ID GROUP BY T2.Name, T3.Shop_ID	employee_hire_evaluation
SELECT shop.Name, COUNT(employee.Employee_ID) FROM shop JOIN hiring ON shop.Shop_ID = hiring.Shop_ID JOIN employee ON hiring.Employee_ID = employee.Employee_ID GROUP BY shop.Shop_ID	employee_hire_evaluation
SELECT SUM(Bonus) FROM evaluation	employee_hire_evaluation
SELECT SUM(bonus) FROM evaluation	employee_hire_evaluation
SELECT employee.Name, evaluation.Year_awarded, evaluation.Bonus, hiring.Start_from, hiring.Is_full_time, shop.Name, shop.Location, shop.District, shop.Number_products, shop.Manager_name FROM employee JOIN hiring ON employee.Employee_ID = hiring.Employee_ID JOIN shop ON hiring.Shop_ID = shop.Shop_ID	employee_hire_evaluation
SELECT employee.Name, evaluation.Year_awarded, evaluation.Bonus, hiring.Start_from, hiring.Is_full_time, shop.Location, shop.District FROM employee JOIN hiring ON employee.Employee_ID = hiring.Employee_ID JOIN shop ON hiring.Shop_ID = shop.Shop_ID	employee_hire_evaluation
SELECT DISTINCT District FROM shop WHERE Shop_ID IN (SELECT Shop_ID FROM shop WHERE Number_products < 3000) INTERSECT SELECT DISTINCT District FROM shop WHERE Shop_ID IN (SELECT Shop_ID FROM shop WHERE Number_products > 10000)	employee_hire_evaluation
SELECT DISTINCT District FROM shop WHERE Shop_ID IN (SELECT Shop_ID FROM shop WHERE Number_products < 3000) INTERSECT SELECT DISTINCT District FROM shop WHERE Shop_ID IN (SELECT Shop_ID FROM shop WHERE Number_products > 10000)	employee_hire_evaluation
SELECT DISTINCT Location FROM shop	employee_hire_evaluation
SELECT DISTINCT Location FROM shop	employee_hire_evaluation
SELECT COUNT(*) FROM conductor	orchestra
SELECT COUNT(*) FROM conductor	orchestra
SELECT name FROM conductor ORDER BY age ASC	orchestra
SELECT name FROM conductor ORDER BY age	orchestra
SELECT name FROM conductor WHERE nationality ! = 'usa'	orchestra
SELECT Name FROM conductor WHERE Nationality ! = 'usa'	orchestra
SELECT Record_Company FROM orchestra ORDER BY Year_of_Founded DESC	orchestra
SELECT Record_Company FROM orchestra ORDER BY Year_of_Founded DESC	orchestra
SELECT AVG(attendance) FROM show JOIN performance ON show.Performance_ID = performance.Performance_ID JOIN orchestra ON performance.Orchestra_ID = orchestra.Orchestra_ID	orchestra
SELECT AVG(attendance) FROM show JOIN performance ON show.Performance_ID = performance.Performance_ID JOIN orchestra ON performance.Orchestra_ID = orchestra.Orchestra_ID JOIN conductor ON orchestra.Conductor_ID = conductor.Conductor_ID	orchestra
SELECT MAX(Share), MIN(Share) FROM performance WHERE Type ! = 'Live final' GROUP BY Orchestra_ID	orchestra
SELECT MAX(Share) AS 'max_share', MIN(Share) AS 'min_share' FROM performance JOIN orchestra ON performance.Orchestra_ID = orchestra.Orchestra_ID WHERE Type ! = 'Live final' GROUP BY Orchestra_ID	orchestra
SELECT DISTINCT Nationality FROM conductor	orchestra
SELECT DISTINCT Nationality FROM conductor	orchestra
SELECT name FROM conductor ORDER BY year_of_work DESC	orchestra
SELECT name FROM conductor ORDER BY Year_of_Work DESC	orchestra
SELECT Name FROM conductor WHERE Year_of_Work IN (SELECT MAX(Year_of_Work) FROM conductor GROUP BY Conductor_ID)	orchestra
SELECT Name FROM conductor WHERE Year_of_Work = (SELECT MAX(Year_of_Work) FROM conductor)	orchestra
SELECT conductor.Name, orchestra.Orchestra FROM conductor JOIN orchestra ON conductor.Conductor_ID = orchestra.Conductor_ID	orchestra
SELECT conductor.Name, orchestra.Orchestra FROM conductor JOIN orchestra ON conductor.Conductor_ID = orchestra.Conductor_ID	orchestra
SELECT T1.Name FROM conductor AS T1 JOIN orchestra AS T2 ON T1.Conductor_ID = T2.Conductor_ID GROUP BY T1.Conductor_ID HAVING COUNT(DISTINCT T2.Orchestra_ID) > 1	orchestra
SELECT T1.Name FROM conductor AS T1 JOIN orchestra AS T2 ON T1.Conductor_ID = T2.Conductor_ID GROUP BY T1.Conductor_ID HAVING COUNT(DISTINCT T2.Orchestra_ID) > 1	orchestra
SELECT T1.Name FROM conductor AS T1 JOIN orchestra AS T2 ON T1.Conductor_ID = T2.Conductor_ID GROUP BY T1.Conductor_ID ORDER BY COUNT(T2.Orchestra_ID) DESC LIMIT 1	orchestra
SELECT T1.Name FROM conductor AS T1 JOIN orchestra AS T2 ON T1.Conductor_ID = T2.Conductor_ID GROUP BY T1.Conductor_ID ORDER BY COUNT(T2.Orchestra_ID) DESC LIMIT 1	orchestra
SELECT Name FROM conductor JOIN orchestra ON conductor.Conductor_ID = orchestra.Conductor_ID JOIN performance ON orchestra.Orchestra_ID = performance.Orchestra_ID JOIN show ON performance.Performance_ID = show.Performance_ID WHERE orchestra.Year_of_Founded > 2008	orchestra
SELECT Name FROM conductor WHERE EXISTS (SELECT * FROM orchestra WHERE conductor.Conductor_ID = orchestra.Conductor_ID AND Year_of_Founded > 2008)	orchestra
SELECT Record_Company, COUNT(*) FROM orchestra GROUP BY Record_Company	orchestra
SELECT Record_Company, COUNT(*) FROM orchestra GROUP BY Record_Company	orchestra
SELECT Major_Record_Format FROM orchestra GROUP BY Major_Record_Format ORDER BY COUNT(*) ASC	orchestra
SELECT Major_Record_Format, COUNT(*) AS frequency FROM orchestra GROUP BY Major_Record_Format ORDER BY frequency DESC	orchestra
SELECT Record_Company FROM orchestra GROUP BY Record_Company ORDER BY COUNT(*) DESC LIMIT 1	orchestra
SELECT Record_Company FROM orchestra GROUP BY Record_Company ORDER BY COUNT(*) DESC LIMIT 1	orchestra
SELECT Orchestra FROM orchestra WHERE Orchestra_ID NOT IN (SELECT Performance_ID FROM performance)	orchestra
SELECT Orchestra FROM orchestra WHERE Orchestra_ID NOT IN (SELECT Orchestra_ID FROM performance)	orchestra
SELECT DISTINCT Record_Company FROM orchestra WHERE Year_of_Founded < 2003 AND Orchestra_ID IN (SELECT Orchestra_ID FROM orchestra WHERE Year_of_Founded > 2003)	orchestra
SELECT Record_Company FROM orchestra WHERE Orchestra_ID IN (SELECT Conductor_ID FROM conductor JOIN orchestra ON conductor.Conductor_ID = orchestra.Conductor_ID WHERE Year_of_Founded < 2003) INTERSECT SELECT Record_Company FROM orchestra WHERE Orchestra_ID IN (SELECT Conductor_ID FROM conductor JOIN orchestra ON conductor.Conductor_ID = orchestra.Conductor_ID WHERE Year_of_Founded > 2003)	orchestra
SELECT COUNT(*) FROM orchestra WHERE Major_Record_Format IN ('CD', 'DVD')	orchestra
SELECT COUNT(*) FROM orchestra WHERE Major_Record_Format IN ('CD', 'DVD')	orchestra
SELECT Year_of_Founded FROM orchestra WHERE Orchestra_ID IN (SELECT Oracle_ID FROM performance GROUP BY Oracle_ID HAVING COUNT(*) > 1)	orchestra
SELECT Year_of_Founded FROM orchestra WHERE Orchestra_ID IN (SELECT Orchestra_ID FROM performance GROUP BY Orchestra_ID HAVING COUNT(*) > 1)	orchestra
SELECT COUNT(*) FROM singer	singer
SELECT COUNT(*) FROM singer	singer
SELECT name FROM singer ORDER BY Net_Worth_Millions ASC	singer
SELECT name FROM singer JOIN (SELECT Singer_ID, Net_Worth_Millions FROM singer ORDER BY Net_Worth_Millions ASC) AS T ON singer.Singer_ID = T.Singer_ID ORDER BY T.Net_Worth_Millions ASC	singer
SELECT Birth_Year, Citizenship FROM singer	singer
SELECT Birth_Year, Citizenship FROM singer	singer
SELECT name FROM singer WHERE Citizenship ! = 'France'	singer
SELECT name FROM singer WHERE Citizenship ! = 'France'	singer
SELECT name FROM singer WHERE Birth_Year IN (1948, 1949)	singer
SELECT name FROM singer WHERE Birth_Year IN (1948, 1949)	singer
SELECT Name FROM singer WHERE Net_Worth_Millions = (SELECT MAX(Net_Worth_Millions) FROM singer)	singer
SELECT Name FROM singer WHERE Net_Worth_Millions = (SELECT MAX(Net_Worth_Millions) FROM singer)	singer
SELECT Citizenship, COUNT(*) FROM singer GROUP BY Citizenship	singer
SELECT Citizenship, COUNT(*) FROM singer GROUP BY Citizenship	singer
SELECT Citizenship FROM singer GROUP BY Citizenship ORDER BY COUNT(*) DESC LIMIT 1	singer
SELECT Citizenship AS common_citizenship FROM (SELECT Citizenship, COUNT(*) AS count FROM singer GROUP BY Citizenship) AS T1 JOIN (SELECT Citizenship, COUNT(*) AS count FROM singer JOIN song ON singer.Singer_ID = song.Singer_ID GROUP BY Citizenship) AS T2 ON T1.citizenship = T2.citizenship ORDER BY count DESC LIMIT 1	singer
SELECT Citizenship, MAX(Net_Worth_Millions) FROM singer LEFT JOIN song ON singer.Singer_ID = song.Singer_ID GROUP BY Citizenship	singer
SELECT Citizenship, MAX(Net_Worth_Millions) FROM singer LEFT JOIN song ON singer.Singer_ID = song.Singer_ID GROUP BY Citizenship	singer
SELECT song.Title, singer.Name FROM singer JOIN song ON singer.Singer_ID = song.Singer_ID	singer
SELECT singer.name, song.title FROM singer JOIN song ON singer.Singer_ID = song.Singer_ID	singer
SELECT DISTINCT name FROM singer JOIN song ON singer.Singer_ID = song.Singer_ID WHERE song.Sales > 300000	singer
SELECT Name FROM singer JOIN song ON singer.Singer_ID = song.Singer_ID WHERE song.Sales > 300000	singer
SELECT name FROM singer WHERE singer_id IN (SELECT Singer_ID FROM song GROUP BY Singer_ID HAVING COUNT(*) > 1)	singer
SELECT name FROM singer WHERE singer_id IN (SELECT Singer_ID FROM song GROUP BY Singer_ID HAVING COUNT(*) > 1)	singer
SELECT `singer`.`name`, SUM(`song`.`sales`) FROM `singer` JOIN `song` ON `singer`.`Singer_ID` = `song`.`Singer_ID` GROUP BY `singer`.`Name`	singer
SELECT Singer_ID, Name, SUM(Sales) AS Total_Sales FROM song JOIN singer ON song.Singer_ID = singer.Singer_ID GROUP BY Singer_ID, Name	singer
SELECT Name FROM singer WHERE Singer_ID NOT IN (SELECT Singer_ID FROM song)	singer
SELECT name FROM singer WHERE singer_id NOT IN (SELECT singer_id FROM song)	singer
SELECT DISTINCT Citizenship FROM singer WHERE Singer_ID IN (SELECT Singer_ID FROM singer WHERE Birth_Year < 1945 UNION SELECT Singer_ID FROM singer WHERE Birth_Year > 1955)	singer
SELECT DISTINCT Citizenship FROM singer WHERE Singer_ID IN (SELECT Singer_ID FROM singer WHERE Birth_Year < 1945) INTERSECT SELECT Singer_ID FROM singer WHERE Birth_Year > 1955	singer
