select count(*) from singer	concert_singer
select count(*) from singer	concert_singer
select name, country, age from singer order by age desc	concert_singer
select name, country, age from singer order by age desc	concert_singer
select avg(age) , min(age) , max(age) from singer where country = 'france'	concert_singer
select avg(age) as average_age, min(age) as minimum_age, max(age) as maximum_age from singer where country = 'france'	concert_singer
select t1.song_name, t1.song_release_year from singer as t1 join singer_in_concert as t2 on t1.singer_id = t2.singer_id join concert as t3 on t2.concert_id = t3.concert_id where t1.age = (select min(age) from singer)	concert_singer
select song_name, song_release_year from singer where age = (select min(age) from singer)	concert_singer
select country from singer where age > 20 group by country	concert_singer
select country from singer where age > 20 group by country	concert_singer
select country, count(*) from singer group by country	concert_singer
select country, count(*) from singer group by country	concert_singer
select T1.song_name from singer as T1 join singer_in_concert as T2 on T1.singer_id = T2.singer_id join concert as T3 on T2.concert_id = T3.concert_id where T1.age > (select avg(age) from singer)	concert_singer
select s.song_name from singer as s join singer_in_concert as sic on s.singer_id = sic.singer_id join concert as c on sic.concert_id = c.concert_id where s.age > (select avg(age) from singer)	concert_singer
select location, name from stadium where capacity between 5000 and 10000	concert_singer
select location, name from stadium where capacity between 5000 and 10000	concert_singer
select max(capacity) as max_capacity , avg(capacity) as avg_capacity from stadium	concert_singer
select avg(capacity) as average_capacity , max(capacity) as maximum_capacity from stadium	concert_singer
select name, capacity from stadium where average = (select avg(average) from stadium order by average desc limit 1)	concert_singer
select name, capacity from stadium where average = (select max(average) from stadium)	concert_singer
select count(*) from concert where year = '2014' union select count(*) from concert where year = '2015'	concert_singer
select count(*) from concert where year = 2014 union select count(*) from concert where year = 2015	concert_singer
select t2.name, count(*) from concert as t1 join stadium as t2 on t1.stadium_id = t2.stadium_id group by t2.name	concert_singer
select t1.stadium_id, count(*) from stadium as t1 join concert as t2 on t1.stadium_id = t2.stadium_id group by t1.stadium_id	concert_singer
select t2.name, t2.capacity from concert as t1 join stadium as t2 on t1.stadium_id = t2.stadium_id where t1.year > = 2014 group by t2.stadium_id order by count(*) desc limit 1	concert_singer
select t2.name, t2.capacity from concert as t1 join stadium as t2 on t1.stadium_id = t2.stadium_id where t1.year > 2013 group by t2.stadium_id order by count(*) desc limit 1	concert_singer
select year from concert group by year order by count(*) desc limit 1	concert_singer
select year from concert group by year order by count(*) desc limit 1	concert_singer
SELECT name FROM stadium WHERE stadium_id NOT IN (SELECT stadium_id FROM concert)	concert_singer
select name from stadium except select T2.name from concert as T1 join stadium as T2 on T1.stadium_id = T2.stadium_id	concert_singer
SELECT country FROM singer WHERE age > 40 INTERSECT SELECT country FROM singer WHERE age < 30	concert_singer
select name from stadium where stadium_id not in (select stadium_id from concert where year = '2014')	concert_singer
select name from stadium except select T2.name from concert as T1 join stadium as T2 on T1.stadium_id = T2.stadium_id where T1.year = 2014	concert_singer
select T1.concert_name, T1.theme, count(*) from concert as T1 join singer_in_concert as T2 on T1.concert_id = T2.concert_id group by T1.concert_id	concert_singer
select T4.concert_name, T4.theme, count(*) from singer_in_concert as T1 join singer as T2 on T1.singer_id = T2.singer_id join concert as T3 on T1.concert_id = T3.concert_id join stadium as T4 on T3.stadium_id = T4.stadium_id group by T4.concert_name, T4.theme	concert_singer
select T1.name , count(*) from singer as T1 join singer_in_concert as T2 on T1.singer_id = T2.singer_id join concert as T3 on T2.concert_id = T3.concert_id group by T1.name	concert_singer
select s.name, count(c.concert_id) from singer as s join singer_in_concert as sc on s.singer_id = sc.singer_id join concert as c on sc.concert_id = c.concert_id group by s.singer_id, s.name	concert_singer
select T3.name from singer_in_concert as T1 join singer as T3 on T1.singer_id = T3.singer_id join concert as T2 on T1.concert_id = T2.concert_id where T2.year = '2014'	concert_singer
select T3.name from singer_in_concert as T1 join singer as T3 on T1.singer_id = T3.singer_id join concert as T2 on T1.concert_id = T2.concert_id where T2.year = 2014	concert_singer
select t1.name, t1.country from singer as t1 join singer_in_concert as t2 on t1.singer_id = t2.singer_id join concert as t3 on t2.concert_id = t3.concert_id where t1.song_name like '%Hey '	concert_singer
select name, country from singer where song_name like '%hey %' intersect select name, country from singer	concert_singer
SELECT T2.location, T2.name FROM concert AS T1 JOIN stadium AS T2 ON T1.stadium_id = T2.stadium_id WHERE T1.year = '2014' INTERSECT SELECT T2.location, T2.name FROM concert AS T1 JOIN stadium AS T2 ON T1.stadium_id = T2.stadium_id WHERE T1.year = '2015'	concert_singer
select t2.name, t2.location from concert as t1 join stadium as t2 on t1.stadium_id = t2.stadium_id where year = 2014 intersect select t2.name, t2.location from concert as t1 join stadium as t2 on t1.stadium_id = t2.stadium_id where year = 2015	concert_singer
select count(*) from concert as c join stadium as s on c.stadium_id = s.stadium_id where s.capacity = (select max(capacity) from stadium)	concert_singer
select count(*) from concert where stadium_id = (select stadium_id from stadium order by capacity desc limit 1)	concert_singer
select count(*) from has_pet as T1 join pets as T2 on T1.petid = T2.petid where T2.weight > 10	pets_1
select count(*) from has_pet as T1 join pets as T2 on T1.petid = T2.petid where T2.weight > 10	pets_1
select weight from pets where pet_age = (select min(pet_age) from pets where pettype = 'dog') and pettype = 'dog'	pets_1
select min(pet_age)*1.0*weight from pets where pettype = 'dog' intersect select max(weight) from pets where pettype = 'dog'	pets_1
select max(t2.weight) , t2.pettype from pets as t2 join has_pet as t1 on t2.petid = t1.petid group by t2.pettype	pets_1
select max(t3.weight) , t3.pettype from pets as t3 join has_pet as t1 on t3.petid = t1.petid group by t3.pettype	pets_1
select count(*) from has_pet as T1 join student as T2 on T1.StuID = T2.StuID where T2.Age > 20	pets_1
select count(*) from has_pet as T1 join student as T2 on T1.StuID = T2.StuID where T2.Age > 20	pets_1
select count(*) from has_pet as T1 join pets as T2 on T1.petid = T2.petid where T1.stuid in (select stuid from student where sex = 'F') and T2.pettype = 'dog'	pets_1
select count(*) from has_pet as T1 join student as T2 on T1.stuid = T2.stuid join pets as T3 on T1.petid = T3.petid where T2.sex = 'F' and T3.pettype = 'dog'	pets_1
select count(*) from pets group by pettype	pets_1
select count(*) from pets group by pettype	pets_1
select T1.fname from student as T1 join has_pet as T2 on T1.stuid = T2.StuID join pets as T3 on T2.PetID = T3.PetID where T3.PetType = 'cat' union select T1.fname from student as T1 join has_pet as T2 on T1.stuid = T2.StuID join pets as T3 on T2.PetID = T3.PetID where T3.PetType = 'dog'	pets_1
select T1.fname from student as T1 join has_pet as T2 on T1.stuid = T2.stuID join pets as T3 on T2.petid = T3.petid where T3.pettype like '%cat%' union select T1.fname from student as T1 join has_pet as T2 on T1.stuid = T2.stuID join pets as T3 on T2.petid = T3.petid where T3.pettype like '%dog%'	pets_1
select T1.fname from student as T1 join has_pet as T2 on T1.StuID = T2.StuID join pets as P1 on T2.PetID = P1.PetID where P1.PetType = 'cat' intersect select T1.fname from student as T1 join has_pet as T2 on T1.StuID = T2.StuID join pets as P1 on T2.PetID = P1.PetID where P1.PetType = 'dog'	pets_1
select T1.fname from student as T1 join has_pet as T2 on T1.stuid = T2.stuID join pets as P1 on T2.petid = P1.petid where P1.pettype = 'cat' intersect select T1.fname from student as T1 join has_pet as T2 on T1.stuid = T2.stuID join pets as P1 on T2.petid = P1.petid where P1.pettype = 'dog'	pets_1
select major , age from student where stuid not in (select stuid from has_pet where petid in (select petid from pets where pettype = 'cat'))	pets_1
select s.major,s.age from student as s where s.stuid not in (select h.stuid from has_pet as h join pets as p on h.petid = p.petid where p.petttype = 'cat') intersect select s.major,s.age from student as s	pets_1
select stuid from has_pet where petid not in (select petid from pets where pettype = 'cat')	pets_1
SELECT stuid FROM has_pet WHERE petid NOT IN (SELECT petid FROM pets WHERE pettype = 'cat')	pets_1
select s.fname, s.age from student s join has_pet hp on s.stuid = hp.stuid join pets p on hp.petid = p.petid where p.pettype = 'dog' and s.stuid not in (select stuid from has_pet join pets on has_pet.petid = pets.petid where pets.pettype = 'cat')	pets_1
SELECT T1.fname FROM student AS T1 JOIN has_pet AS T2 ON T1.stuID = T2.StuID JOIN pets AS P ON T2.petid = P.PetID WHERE P.pettype = 'dog' AND P.pettype NOT IN (SELECT pettype FROM pets WHERE pettype = 'cat')	pets_1
select p.pettype, p.weight from pets as p join has_pet as h on p.petid = h.petid where p.pet_age = (select min(pet_age) from pets)	pets_1
select t3.pettype, t3.weight from has_pet as t1 join pets as t3 on t1.petid = t3.petid where t3.pet_age = (select min(pet_age) from pets)	pets_1
select petid, weight from pets where pet_age > 1	pets_1
select petid, weight from pets where pet_age > 1	pets_1
select avg(pet_age) as avg_age, pettype from pets group by pettype union select max(pet_age) as max_age, pettype from pets group by pettype	pets_1
select avg(pet_age) as avg_age, pettype from pets group by pettype union select max(pet_age) as max_age, pettype from pets group by pettype	pets_1
select avg(weight) , pettype from pets group by pettype	pets_1
select pettype, avg(weight) from pets group by pettype	pets_1
select s.fname, s.age from student as s join has_pet as hp on s.stuid = hp.stuID join pets as p on hp.petid = p.petid	pets_1
select T1.fname , T1.age from student as T1 join has_pet as T2 on T1.stuid = T2.stuID join pets as T3 on T2.petid = T3.petid union select fname , age from student where stuid not in (select stuID from has_pet)	pets_1
select T1.petid from has_pet as T1 join student as T2 on T1.stuid = T2.stuidid where T2.lname = 'Smith'	pets_1
select T1.petid from has_pet as T1 join student as T2 on T1.stuid = T2.stuidid where T2.lname = 'Smith '	pets_1
select count(*) from has_pet as T1 join student as T2 on T1.stuid = T2.stuid where T1.stuid in (select stuid from has_pet)	pets_1
select stuid, count(*) from has_pet group by stuid	pets_1
select t1.fname, t1.sex from student as t1 join has_pet as t2 on t1.stuid = t2.stuID join pets as p on t2.petid = p.petid group by t1.stuid having count(*) > 1	pets_1
select t1.fname, t1.sex from student as t1 join has_pet as t2 on t1.stuid = t2.stuid group by t1.stuid having count(*) > 1	pets_1
select T1.lname from student as T1 join has_pet as T2 on T1.stuid = T2.stuID join pets as T3 on T2.petid = T3.petid where T3.pettype = 'cat' and T3.pet_age = 3	pets_1
select s.lname from student as s join has_pet as hp on s.stuid = hp.stuid join pets as p on hp.petid = p.petid where p.pettype = 'cat' and p.pet_age = 3	pets_1
select avg(t1.age) from student as t1 where t1.stuid not in (select stuid from has_pet)	pets_1
select avg(t1.age) from student as t1 where t1.stuid not in (select stuid from has_pet)	pets_1
select count(*) from employee	employee_hire_evaluation
select count(*) from employee	employee_hire_evaluation
select name from employee order by age asc	employee_hire_evaluation
select name from employee order by age asc	employee_hire_evaluation
select city , count(*) from employee group by city	employee_hire_evaluation
select city, count(*) from employee group by city	employee_hire_evaluation
select city from employee where age < 30 and city in (select city from employee where age < 30) intersect select city from employee where age < 30 group by city having count(*) > 1	employee_hire_evaluation
select city from employee where age < 30 and city in (select city from employee where age < 30) group by city having count(*) > 1	employee_hire_evaluation
select location, count(*) from shop group by location	employee_hire_evaluation
select location , count(*) from shop group by location	employee_hire_evaluation
select T2.manager_name, T2.district from shop as T1 join employee as T2 on T1.manager_name = T2.name join hiring as H on T1.shop_id = H.shop_id where T1.number_products = (select max(number_products) from shop)	employee_hire_evaluation
select T2.manager_name, T2.district from shop as T1 join employee as T2 on T1.manager_name = T2.name join hiring as H on T1.shop_id = H.shop_id where H.is_full_time = true and H.start_from = (select start_from from hiring where is_full_time = true group by start_from order by count(*) desc limit 1) intersect select manager_name, district from shop where number_products = (select max(number_products) from shop)	employee_hire_evaluation
select min(number_products) as min_products, max(number_products) as max_products from shop	employee_hire_evaluation
select min(number_products) , max(number_products) from shop	employee_hire_evaluation
select t2.name, t2.location, t2.district from shop as t2 join hiring as t1 on t2.shop_id = t1.shop_id group by t2.shop_id order by t2.number_products desc	employee_hire_evaluation
select t2.name, t2.location, t2.district from shop as t2 join hiring as t1 on t2.shop_id = t1.shop_id group by t2.shop_id order by t2.number_products desc	employee_hire_evaluation
select t2.name from shop as t2 where t2.number_products > (select avg(number_products) from shop)	employee_hire_evaluation
select T2.name from shop as T2 where T2.number_products > (select avg(number_products) from shop)	employee_hire_evaluation
select Name from employee where Employee_ID = (select Employee_ID from evaluation group by Employee_ID order by count(*) desc limit 1)	employee_hire_evaluation
select name from employee where employee_id = (select employee_id from evaluation group by employee_id order by count(*) desc limit 1)	employee_hire_evaluation
select name from employee where employee_id = (select employee_id from evaluation order by bonus desc limit 1)	employee_hire_evaluation
select name from employee where employee_id = (select employee_id from evaluation order by bonus desc limit 1)	employee_hire_evaluation
select name from employee where employee_id not in (select employee_id from evaluation)	employee_hire_evaluation
select name from employee where employee_id not in (select employee_id from evaluation)	employee_hire_evaluation
select t2.name from hiring as t1 join shop as t2 on t1.shop_id = t2.shop_id group by t2.shop_id order by count(*) desc limit 1	employee_hire_evaluation
select T2.name from hiring as T1 join shop as T2 on T1.shop_id = T2.shop_id group by T2.shop_id order by count(*) desc limit 1	employee_hire_evaluation
select t2.name from shop as t2 where t2.shop_id not in (select t1.shop_id from hiring as t1)	employee_hire_evaluation
select T2.name from shop as T2 where T2.shop_id not in (select T1.shop_id from hiring as T1)	employee_hire_evaluation
select T2.name, count(*) from hiring as T1 join shop as T2 on T1.shop_id = T2.shop_id group by T2.name	employee_hire_evaluation
select count(T1.employee_id) as num_employees, T2.name from hiring as T1 join shop as T2 on T1.shop_id = T2.shop_id group by T2.name	employee_hire_evaluation
select sum(bonus) from evaluation	employee_hire_evaluation
select sum(bonus) from evaluation	employee_hire_evaluation
select * from hiring as h	employee_hire_evaluation
select * from hiring	employee_hire_evaluation
SELECT district FROM shop WHERE number_products < 3000 INTERSECT SELECT district FROM shop WHERE number_products > 10000	employee_hire_evaluation
select district from shop where number_products < 3000 intersect select district from shop where number_products > 10000	employee_hire_evaluation
select count(*) from shop	employee_hire_evaluation
select count(*) from shop	employee_hire_evaluation
select count(*) from conductor	orchestra
select count(*) from conductor	orchestra
select name from conductor order by age asc	orchestra
select name from conductor order by age	orchestra
select name from conductor where nationality != 'usa'	orchestra
select name from conductor where nationality NOT IN ('USA')	orchestra
select t2.record_company from orchestra as t1 join conductor as t2 on t1.conductor_id = t2.Conductor_ID order by t1.Year_of_Founded desc	orchestra
select t2.record_company from orchestra as t1 join conductor as t2 on t1.conductor_id = t2.Conductor_ID order by t1.Year_of_Founded desc	orchestra
select avg(t4.attendance) from show as t4	orchestra
select avg(attendance) from show	orchestra
select max(t1.share) , min(t1.share) from performance as t1 where t1.type != 'Live final'	orchestra
select max(t1.share) , min(t1.share) from performance as t1 where t1.type != 'Live final'	orchestra
select count(*) from conductor group by nationality	orchestra
select count(*) from conductor group by nationality	orchestra
select name from conductor order by year_of_work desc	orchestra
select name from conductor order by year_of_work desc	orchestra
select name from conductor where year_of_work = (select max(year_of_work) from conductor)	orchestra
select name from conductor where year_of_work = (select max(year_of_work) from conductor)	orchestra
select T1.name, T2.orchestra from conductor as T1 join orchestra as T2 on T1.conductor_id = T2.conductor_id	orchestra
select T1.name, T2.orchestra from conductor as T1 join orchestra as T2 on T1.conductor_id = T2.conductor_id	orchestra
select name from conductor where conductor_id in (select conductor_id from orchestra group by conductor_id having count(*) > 1)	orchestra
select name from conductor where Conductor_ID in (select Conductor_ID from orchestra group by Conductor_ID having count(*) > 1)	orchestra
select name from conductor where conductor_id in (select conductor_id from orchestra group by conductor_id order by count(*) desc limit 1)	orchestra
select t1.name from conductor as t1 join orchestra as t2 on t1.conductor_id = t2.conductor_id group by t1.name order by count(*) desc limit 1	orchestra
select t1.name from conductor as t1 join orchestra as t2 on t1.conductor_id = t2.conductor_id where t2.year_of_founded > 2008	orchestra
select t1.name from conductor as t1 join orchestra as t2 on t1.conductor_id = t2.conductor_id where t2.year_of_founded > 2008	orchestra
select record_company , count(*) from orchestra group by record_company	orchestra
select record_company , count(*) from orchestra group by record_company	orchestra
select major_record_format from orchestra group by major_record_format order by count(*) asc	orchestra
select major_record_format from orchestra group by major_record_format order by count(*) desc	orchestra
select t2.record_company from orchestra as t1 join conductor as t2 on t1.conductor_id = t2.Conductor_ID group by t2.record_company order by count(*) desc limit 1	orchestra
select record_company from orchestra where conductor_id in (select conductor_id from orchestra group by conductor_id order by count(*) desc limit 1)	orchestra
SELECT orchestra FROM orchestra WHERE orchestra_id NOT IN (SELECT orchestra_id FROM performance)	orchestra
SELECT orchestra FROM orchestra WHERE orchestra_id NOT IN (SELECT orchestra_id FROM performance)	orchestra
SELECT T2.record_company FROM orchestra AS T1 JOIN conductor AS T2 ON T1.conductor_id = T2.Conductor_ID WHERE T1.Year_of_Founded < 2003 INTERSECT SELECT T2.record_company FROM orchestra AS T1 JOIN conductor AS T2 ON T1.conductor_id = T2.Conductor_ID WHERE T1.Year_of_Founded > 2003	orchestra
SELECT T4.record_company FROM orchestra AS T1 JOIN performance AS T2 ON T1.orchestra_id = T2.orchchestra_id JOIN conductor AS T3 ON T1.conductor_id = T3.conductor_id JOIN orchestra AS T5 ON T1.orchestra_id = T5.orchestra_id JOIN show AS T6 ON T2.performance_id = T6.performance_id JOIN conductor AS T7 ON T5.conductor_id = T7.conductor_id JOIN orchestra AS T8 ON T5.orchestra_id = T8.orchestra_id JOIN performance AS T9 ON T8.orchestra_id = T9.orchchestra_id JOIN conductor AS T10 ON T8.conductor_id = T10.conductor_id WHERE T1.year_of_founded < 2003 INTERSECT SELECT T4.record_company FROM orchestra AS T5 JOIN performance AS T6 ON T5.orchestra_id = T6.orchchestra_id JOIN conductor AS T7 ON T5.conductor_id = T7.conductor_id JOIN orchestra AS T8 ON T5.orchestra_id = T8.orchestra_id JOIN show AS T9 ON T6.performance_id = T9.performance_id JOIN conductor AS T10 ON T8.conductor_id = T10.conductor_id WHERE T5.year_of_founded > 2003	orchestra
select count(*) from orchestra where major_record_format = 'cd' union select count(*) from orchestra where major_record_format = 'dvd'	orchestra
select count(*) from orchestra where major_record_format = 'cd' union select count(*) from orchestra where major_record_format = 'dvd'	orchestra
select year_of_founded from orchestra where orchestra_id in (select orchestra_id from performance group by orchestra_id having count(*) > 1)	orchestra
select year_of_founded from orchestra where orchestra_id in (select orchestra_id from performance group by orchestra_id having count(*) > 1)	orchestra
select count(*) from singer	singer
select count(*) from singer	singer
select name from singer order by net_worth_millions asc	singer
select name from singer order by net_worth_millions ASC	singer
select birth_year , citizenship from singer	singer
select birth_year , citizenship from singer	singer
select name from singer where citizenship not in (select citizenship from singer where citizenship = 'france')	singer
select name from singer where citizenship != 'french'	singer
select name from singer where birth_year = 1948 union select name from singer where birth_year = 1949	singer
select name from singer where birth_year = 1948 union select name from singer where birth_year = 1949	singer
select name from singer where net_worth_millions = (select max(net_worth_millions) from singer)	singer
select name from singer where net_worth_millions = (select max(net_worth_millions) from singer)	singer
select citizenship, count(*) from singer group by citizenship	singer
select citizenship, count(*) from singer group by citizenship	singer
select citizenship from singer intersect select citizenship from singer	singer
select citizenship from singer intersect select citizenship from singer	singer
select citizenship, max(net_worth_millions) from singer as s group by citizenship	singer
select citizenship, max(net_worth_millions) from singer group by citizenship	singer
select s.title, t.name from song as s join singer as t on s.singer_id = t.singer_id	singer
select s.title,t.name from song as s join singer as t on s.singer_id = t.singer_id	singer
select name from singer where singer_id in (select singer_id from song where sales > 300000)	singer
select name from singer where singer_id in (select singer_id from song where sales > 300000)	singer
select name from singer where singer_id in (select singer_id from song group by singer_id having count(*) > 1)	singer
select name from singer where singer_id in (select singer_id from song group by singer_id having count(*) > 1)	singer
select T1.name, sum(T2.sales) from singer as T1 join song as T2 on T1.singer_id = T2.singer_id group by T1.singer_id	singer
select T1.name, sum(T2.sales) from singer as T1 join song as T2 on T1.singer_id = T2.singer_id group by T1.name	singer
select name from singer where singer_id not in (select singer_id from song)	singer
select name from singer where singer_id not in (select singer_id from song)	singer
select citizenship from singer where birth_year < 1945 intersect select citizenship from singer where birth_year > 1955	singer
select citizenship from singer where birth_year < 1945 intersect select citizenship from singer where birth_year > 1955	singer
